#王国五星
降临天使=天使
光明之龙=光龙
#战神
#圣诞老人
纯洁圣女=圣女,剩女
隐世先知=先知
#圣城卫士
海军司令=司令
浴火龙女=龙女
战场扫荡者=扫荡机,扫荡鸡
魔幻人偶师=人偶
最终兵器=兵器
钢铁巨神兵=巨神兵
#预言之神
制裁之雷神=雷神
均衡女神=均衡
命运占卜师=占卜师
魔装机神=机神,基神,鸡神
月樱公主=公主,月樱,月英
灵峰剑姬=剑姬,贱鸡,剑鸡
叹惋之歌=叹惋
战场女武神=女武神
#圣堂执政官
天界守护者=天界
#星辰主宰
驭灵法师=驭灵
鬼灵搜索师=鬼灵
残翼羽神=残翼
无限之神=无限
#爱之使者
圣剑持有者=圣剑
巨蟹座=巨蟹
狮子座=狮子
大江三鬼·金=大江三鬼金
梦魇猎手·岚=梦魇猎手岚
三国英魂·子龙=三国英魂子龙

#森林五星
金属巨龙=金属
#凤凰
月亮女神=月女
元素灵龙=灵龙
麒麟兽=麒麟
#梦境守护者
圣灵大祭司=圣灵
世界树之灵=世界树
精灵女王=粗腿
黄金金属巨龙=黄金金属
#唤雨师
复活节兔女郎=兔女,兔子
#梦境女神
#圣泉元神
浮云青鸟=青鸟
雷雕之魂=镭雕,雷雕
破晓守卫=破晓
#晓之奏者
百花女神=百花
银河观测者=银河
龙灵使者=龙灵
时光女神=时光
幻翼神丽雅=丽雅,幻翼神
星夜女神=星夜
荆棘妖姬=荆棘
白羊座=白羊
处女座=处女
射手座=射手
梦魇猎手·霜=梦魇猎手霜

#蛮荒五星
#雷兽
九头妖蛇=九头
远古蝎皇=蟹黄,蝎皇,蝎子
暴怒霸龙=霸龙,霸王龙
#毒雾羽龙
羽翼化蛇=化蛇
迷魅灵狐=灵狐
神谕火狐=火狐
#幻翼命运神
远古海妖=海妖
齐天美猴王=猴子
怒雪咆哮=怒血,怒雪
战意斗神=斗神
七彩之影=七彩
龙角将军=龙角
太古魔狼=魔狼
#峦龙
#逐日凶狼=凶狼
#摩羯大祭司
#黄金毒龙
#羽蛇神
九命猫神=猫神
贪吃少女=贪吃
金牛座=金牛
#大毒汁怪
#大毒汁之王
大江三鬼·银=大江三鬼银
梦魇猎手·胧=梦魇猎手胧
三国英魂·翼德=三国英魂翼德

#地狱五星
毁灭之龙=黑龙
灵魂收割者=萝莉
恐惧之王=恐惧
背主之影=背主
幽灵巨龙=幽灵龙
巫妖领主=巫妖
刀锋女王=刀锋
月蚀兽=月食,月蚀
赤面天狗=天狗
亡灵守护神=狗头
混沌之龙=混沌
不死鸟化身=不死鸟
堕落天使=黑丝
#精灵王亡灵
欲望惩罚者=欲望
末日预言师=末日
无尽噩梦=无尽
死域军神=军神
圆月魔女=圆月
#逐月恶狼
蝗虫公爵=蝗虫
#狡诈邪神
彼岸使者=彼岸
永夜真祖=永夜
骨灵巫女=骨灵
#爱神
雪月花=雪月
骑士王血魂=骑士,骑士王
邪月翼魔=邪月
双子座=双子
天秤座=天秤
天蝎座=天蝎
大江三鬼·红=大江三鬼红

#王国四星
大主教=主教
秘银巨石像=秘银
魔法协会长=老头
荣耀巨人=荣耀
大剑圣=剑圣
时空旅者=时空
彩翼公主=彩翼
月镰杀手=月镰
铁血剑豪=剑豪
瓦尔基里英灵=英灵
王国厨师长=厨师长

#森林四星
水源制造者=水源
森林女神=森女

#蛮荒四星
震源岩蟾=蛤蟆